00, 00, 00, 00, 00, 00, 00, 00, 00, 00, 00, 00, 00, 00, 00, 00, 00, 00, 00, 00, 00, 00, 00, 00, 00, 00, 00, 00, 00,  
		00, 00, 00, 00, 00, 01, 01, 00, 00, 00, 00, 00, 00, 00, 00, 00, 00, 00, 00, 00, 00, 00, 00, 00, 00, 00, 00, 00, 00,  
		00, 00, 00, 00, 01, 04, 01, 01, 01, 00, 00, 00, 00, 00, 00, 00, 00, 00, 00, 00, 00, 00, 00, 00, 00, 00, 00, 00, 00,  
		00, 00, 00, 01, 02, 02, 01, 01, 01, 01, 01, 00, 00, 00, 00, 00, 00, 00, 00, 00, 00, 00, 00, 00, 00, 00, 00, 00, 00,  
		00, 00, 01, 02, 01, 02, 01, 01, 01, 01, 06, 01, 00, 00, 00, 00, 00, 00, 00, 00, 00, 00, 00, 00, 00, 00, 00, 00, 00,
		00, 01, 05, 01, 01, 02, 01, 01, 01, 01, 02, 01, 00, 00, 00, 00, 00, 00, 00, 00, 00, 00, 00, 00, 00, 00, 00, 00, 00,
		00, 01, 01, 02, 01, 02, 01, 01, 01, 01, 02, 01, 00, 00, 00, 00, 00, 00, 00, 00, 00, 00, 00, 00, 00, 00, 00, 00, 00,
		00, 01, 01, 01, 02, 02, 01, 01, 01, 01, 02, 01, 01, 00, 00, 00, 00, 00, 00, 00, 00, 00, 00, 00, 00, 00, 00, 00, 00,
		00, 01, 01, 01, 01, 07, 01, 01, 01, 01, 02, 01, 01, 01, 00, 00, 00, 00, 00, 00, 00, 00, 00, 00, 00, 00, 00, 00, 00, 
		00, 00, 01, 01, 02, 01, 02, 01, 01, 01, 02, 01, 01, 01, 01, 01, 00, 00, 00, 00, 00, 00, 00, 00, 00, 00, 00, 00, 00, 
		00, 00, 01, 02, 01, 01, 01,  9, 02, 02,  8, 02, 02, 02, 02, 10, 01, 00, 00, 00, 00, 00, 00, 00, 00, 00, 00, 00, 00, 
		00, 00, 11, 01, 01, 01, 01, 01, 01, 01, 02, 01, 01, 01, 01, 01, 01, 01, 00, 00, 00, 00, 00, 00, 00, 00, 00, 00, 00, 
		00, 00, 00, 01, 01, 01, 01, 01, 01, 01, 02, 01, 01, 01, 01, 01, 01, 01, 00, 00, 00, 00, 00, 00, 00, 00, 00, 00, 00, 
		00, 00, 00, 00, 01, 01, 13, 02, 02, 02, 12, 02, 02, 02, 02, 02, 02, 14, 01, 00, 00, 01, 01, 01, 00, 00, 00, 00, 00, 
		00, 00, 00, 00, 01, 01, 02, 01, 01, 01, 01, 02, 01, 01, 01, 01, 01, 02, 01, 00, 00, 01, 01, 01, 00, 00, 00, 00, 00, 
		00, 00, 00, 00, 01, 01, 02, 01, 01, 01, 01, 01, 02, 01, 01, 01, 01, 02, 01, 00, 01, 01, 01, 00, 00, 00, 00, 00, 00, 
		00, 00, 00, 01, 01, 01, 02, 01, 01, 01, 01, 01, 01, 02, 01, 01, 01, 02, 01, 01, 01, 01, 01, 01, 00, 00, 00, 00, 00, 
		00, 00, 00, 01, 01, 01, 02, 01, 01, 01, 01, 01, 01, 01, 02, 01, 01, 02, 01, 01, 01, 01, 01, 01, 01, 00, 00, 00, 00, 
		00, 00, 01, 01, 01, 01, 02, 01, 01, 01, 01, 01, 01, 01, 01, 18, 01, 02, 01, 01, 01, 01, 01, 01, 01, 01, 01, 00, 00, 
		00, 00, 01, 01, 01, 01, 15, 01, 01, 01, 01, 01, 01, 01, 02, 01, 01, 02, 01, 01, 01, 01, 01, 16, 01, 01, 01, 00, 00, 
		00, 00, 00, 00, 01, 01, 01, 02, 01, 01, 01, 01, 01, 02, 01, 01, 01, 02, 01, 01, 01, 01, 01, 02, 01, 01, 01, 00, 00, 
		00, 00, 00, 00, 00, 01, 01, 01, 02, 01, 01, 01, 02, 01, 01, 01, 01, 17, 02, 02, 02, 02, 02, 19, 01, 01, 00, 00, 00, 
		00, 00, 00, 00, 01, 01, 01, 01, 01, 02, 01, 02, 01, 01, 01, 01, 01, 02, 01, 01, 01, 01, 01, 01, 01, 01, 00, 00, 00, 
		00, 00, 00, 00, 00, 01, 01, 01, 01, 01, 20, 01, 01, 01, 01, 01, 01, 02, 01, 01, 01, 01, 01, 01, 01, 00, 00, 00, 00, 
		00, 00, 00, 00, 00, 00, 01, 01, 01, 01, 01, 02, 01, 01, 01, 01, 01, 02, 01, 01, 01, 01, 01, 01, 01, 00, 00, 00, 00, 
		00, 00, 00, 00, 00, 00, 01, 01, 01, 01, 01, 01, 21, 02, 02, 02, 02, 22, 01, 01, 01, 01, 01, 01, 01, 01, 00, 00, 00, 
		00, 00, 00, 00, 00, 01, 01, 01, 01, 01, 01, 01, 02, 01, 01, 01, 01, 01, 01, 01, 01, 01, 01, 01, 01, 01, 00, 00, 00, 
		00, 00, 00, 00, 00, 01, 01, 01, 01, 01, 01, 01, 02, 01, 01, 01, 01, 01, 01, 01, 01, 01, 01, 01, 01, 01, 01, 00, 00, 
		00, 00, 00, 00, 00, 00, 01, 01, 01, 01, 01, 01, 02, 01, 01, 01, 01, 01, 01, 01, 01, 23, 02, 02, 02, 02, 24, 01, 00, 
		00, 00, 00, 00, 00, 00, 00, 00, 01, 01, 01, 01, 02, 01, 01, 01, 01, 01, 01, 01, 01, 02, 01, 01, 01, 01, 01, 01, 00,
		00, 00, 00, 00, 00, 00, 00, 00, 00, 01, 01, 01, 26, 01, 01, 01, 01, 01, 01, 01, 01, 25, 01, 01, 01, 01, 01, 01, 00, 
		00, 00, 00, 00, 00, 00, 00, 00, 00, 00, 01, 01, 01, 02, 01, 01, 01, 01, 01, 01, 01, 02, 01, 01, 01, 01, 00, 00, 00, 
		00, 00, 00, 00, 00, 00, 00, 00, 00, 00, 01, 01, 01, 01, 27, 01, 01, 01, 01, 01, 01, 02, 01, 01, 00, 00, 00, 00, 00, 
		00, 00, 00, 00, 00, 00, 00, 00, 00, 00, 00, 01, 01, 01, 02, 01, 01, 01, 01, 01, 01, 02, 01, 01, 00, 00, 00, 00, 00, 
		00, 00, 00, 00, 00, 00, 00, 00, 00, 00, 00, 01, 01, 01, 28, 02, 02, 02, 02, 02, 02, 29, 01, 01, 00, 00, 00, 00, 00, 
		00, 00, 00, 00, 00, 00, 00, 00, 00, 00, 01, 01, 01, 01, 02, 01, 01, 01, 01, 01, 01, 01, 01, 01, 00, 00, 00, 00, 00, 
		00, 00, 00, 00, 00, 00, 00, 00, 00, 01, 01, 01, 01, 01, 02, 01, 01, 01, 01, 01, 01, 01, 01, 00, 00, 00, 00, 00, 00, 
		00, 00, 00, 00, 00, 00, 00, 00, 00, 01, 01, 01, 01, 01, 02, 01, 01, 01, 01, 01, 00, 00, 00, 00, 00, 00, 00, 00, 00, 
		00, 00, 00, 00, 00, 00, 00, 00, 00, 00, 01, 01, 01, 01, 02, 01, 01, 01, 00, 00, 00, 00, 00, 00, 00, 00, 00, 00, 00, 
		00, 00, 00, 00, 00, 00, 00, 00, 00, 00, 01, 01, 01, 01, 30, 01, 01, 00, 00, 00, 00, 00, 00, 00, 00, 00, 00, 00, 00, 
		00, 00, 00, 00, 00, 00, 00, 00, 00, 00, 00, 00, 01, 01, 01, 01, 00, 00, 00, 00, 00, 00, 00, 00, 00, 00, 00, 00, 00, 
		00, 00, 00, 00, 00, 00, 00, 00, 00, 00, 00, 00, 00, 01, 00, 00, 00, 00, 00, 00, 00, 00, 00, 00, 00, 00, 00, 00, 00, 
		00, 00, 00, 00, 00, 00, 00, 00, 00, 00, 00, 00, 00, 00, 00, 00, 00, 00, 00, 00, 00, 00, 00, 00, 00, 00, 00, 00, 00, 
